00000000000000000000
11001010100101010110
01001010010100101010
10110100010001011110
10110010010010111010
11010101001011101110
00000000000000000000
01111111111111111111
01010010101001010001
01001010101010101001
01101010100101010111
01111111111111111111
00000000000000000000
