00000000000000000000
00000000001111000000
00000000000000000000
00011111111100000000
00000000000000000000
00000000000000000000
00000111111110000000
00000111111110000000
00000000000000000000
00111111111110000000
00000111111100000000
00000000000000000000
00000000000000000000
